R 1000 1000 
NO ./french_flag.xpm
SO ./t2.xpm
WE ./t3.xpm
EA ./t4.xpm
S ./s.xpm
F 220,100,0
C 225,30,0
11111111111111
100E0000000001
10000000000001
10001000000001
10000000001001
10000002000001
10000000000001
11111111111111