R 1080 720
SO ./t1.xpm
EA ./t2.xpm
NO ./t3.xpm
WE ./t4.xpm
C 255,200,160
F 122,122,122
S ./s.xpm

11111111111111111
10000000000000001
10200000200000201
10000000000000001
10002000200020001
10000000000000001
10202020N02020201
10000000000000001
10002000200200001
10000000000000001
10200000200002001
10000000000000001
11111111111111111