R 1000 1000 
NO ./french_flag.xpm
SO ./t2.xpm
WE ./t3.xpm
EA ./t4.xpm
S ./s.xpm
F 220,100,0
C 225,30,0
11111111111111
10000000000001
100E0000000001
10000001000001
10000000002001
10000020002001
10000000002001
11111111111111