R 1280 720

WE ../textures/t1.xpm
EA ../textures/t2.xpm
S ../textures/s.xpm
NO ../textures/t3.xpm
SO ../textures/t4.xpm

F 0,0,0

C 0,255,253

 11111111111111111111111111
 10000000000000000000000001
 10000000000000000E21222221
110000000000000000000000001
100000000000000010000000011
10000000000000000000000001
10000000000000000000000001
10000000000000000000000001
10000000000000000000000001
10000000000000000000000001
11111111111111111111111111               